OOOOOOOOOOOOOOOOOOOO
OOOOOOOOOOOOOOOOOOOO
OOOOOWWWWWWWWWWWWOOO
OOWWWWWWWWWWWWWWWOOO
OOWWWWRRRRDWWWWWWOOO
OOWWWRRRRRDWWWWWWOOO
OWWWWRRRRWWWWWWWWOOO
OWWWWRRRRWWWWRRRWOOO
OWWWWWRRRRRRRRRRWOOO
OWWWWWWRRRRWWDDRWOOO
OWWWWWWRRRRWWWWRWOOO
OWWWWWWRRRRWWWWRWOOO
OWWWWWWRRRRRRRRRWOOO
OWWWWWWRRRRRRRRRWOOO
OWWWWWWRRRRWWWWWWOOO
OWWWWWWRRRRWWWWWWOOO
OWWWWWWWWWWWWWWWWOOO
OOOOOOOOOOOOOOOOOOOO
OOOOOOOOOOOOOOOOOOOO
OOOOOOOOOOOOOOOOOOOO