OOOOOOOOOOOOOOOOOOOO
OOOOOOOOOOOOOOOOOOOO
OOOOOOOWWWWWOOOOOOOO
OOOOOOOWWDWWOOOOOOOO
OOOOOOOWWRWWOOOOOOOO
OOOOOOOWWRWWOOOOOOOO
OOOWWWWWWRWWWWWWOOOO
OOOWWRRRRRRRRRRWOOOO
OOOWDRRRRRRRRRRWOOOO
OOOWRRRRRRWWWWRWOOOO
OOOWRRRRRRWWWWDWOOOO
OOOWWWWRRRWWWWWWOOOO
OOOOOOWRRRWWOOOOOOOO
OOOOOOWRRRWWOOOOOOOO
OOOOOOWRRDWWOOOOOOOO
OOOOOOWWWWWWOOOOOOOO
OOOOOOOOOOOOOOOOOOOO
OOOOOOOOOOOOOOOOOOOO
OOOOOOOOOOOOOOOOOOOO
OOOOOOOOOOOOOOOOOOOO