OOOOOOOOOOOOOOOOOOOO
OOOOOOOOOOOOOOOOOOOO
OOOOOOOWWWWOOOOOOOOO
OOOOOOOWWWWOOOOOOOOO
OOOOOOOWWWWOOOOOOOOO
OOOOOOOWWWWOOOOOOOOO
OOOOWWWRRRWWWWWWWWOO
OOOOWWWDRRWDDWWWWWOO
OOOOWRRRRRRRRRRRWWOO
OOOOWWDRRRRRRRRRWWOO
OOOOWWWWRRRWWWWWWWOO
OOOOOOOWRRRWOOOOOOOO
OOOOOOOWRRRWOOOOOOOO
OOOOOOOWRRRWOOOOOOOO
OOOOOOOWRRRWOOOOOOOO
OOOOOOOWRRRWOOOOOOOO
OOOOOOOWWWWWOOOOOOOO
OOOOOOOOOOOOOOOOOOOO
OOOOOOOOOOOOOOOOOOOO
OOOOOOOOOOOOOOOOOOOO