OOOOOOOOOOOOOOOOOOOO
OOOOOOOOOOOOOOOOOOOO
OOOOOOOOOOOOOOOOOOOO
OOWWWWWWWWWWWWWWWOOO
OOWWWWWRRDWWWWWWWOOO
OOWWWWWRRRWRRRDWWOOO
OOWWWWWWRRWWRRRWWOOO
OOWWWWWRRRRRRRRWWOOO
OOWWWRRRRRRRWRRWWOOO
OOWWWWRRRRRRWRRWWOOO
OOWWWWWRRRWRWRRWWOOO
OOWWWWWWRRWRWRRWWOOO
OOWWWWWWWRWRRRRWWOOO
OOWWWWWWWRWRRRRRWOOO
OOWWDRRRRRWWRRRDWOOO
OOWWWWWWWWWWWWWWWOOO
OOOOOOOOOOOOOOOOOOOO
OOOOOOOOOOOOOOOOOOOO
OOOOOOOOOOOOOOOOOOOO
OOOOOOOOOOOOOOOOOOOO