OOOOOOOOOOOOOOOOOOOO
OOOOOOOOOOOOOOOOOOOO
OOOOWWWOOOOOWWWOOOOO
OOWWWDWWWWWWWDWWWOOO
OOWWWRWWWWWWWRWWWOOO
OOWWWRRRRRWWWRWWWOOO
OOWWWRRRWRWWWRWWWOOO
OOWWWWWRRRRRRRRRWOOO
OOWWWWRRRRRRRRRRWOOO
OOWWWWWRRRRRRRRRWOOO
OOWWWWRRRWWWWWWWWOOO
OOWWWWRRRDWWWWWWWOOO
OOWWWWRRWWWWWWWWWOOO
OOWWWWRRRRWWWWWWWOOO
OOWWDRRRRRWWWWWWWOOO
OOWWWWWWWWWWWWWWWOOO
OOOOOOOOOOOOOOOOOOOO
OOOOOOOOOOOOOOOOOOOO
OOOOOOOOOOOOOOOOOOOO
OOOOOOOOOOOOOOOOOOOO